##########
#...S....#
#.....##.#
#........#
#.....#..#
#........#
#.....#..#
#....#...#
#......G.#
##########