##########
#.S..#...#
#..#.....#
#..#.....#
#....#...#
#........#
#....#...#
#......G.#
#...#....#
##########