##########
#.S..#...#
#..#.....#
#.....#..#
#..#..#..#
#.....#G.#
#........#
#....#...#
#........#
##########